50 50
0 0 0 20 0 0 10 10 1 20 1 0 1 1 20 20 1 10 0 20 0 10 1 0 10 0 1 20 1 20 0 0 1 0 10 20 10 20 0 20 0 10 1 1 10 0 20 1 1 20
0 1 10 1 10 10 20 20 1 1 0 10 0 0 10 1 10 0 20 20 1 10 10 20 0 10 0 1 0 1 20 20 20 0 0 0 1 1 0 20 1 20 20 20 0 1 0 10 1 20
1 1 0 0 20 1 20 20 10 1 10 1 20 10 1 10 0 20 0 0 0 1 10 0 10 20 10 20 20 10 1 0 0 0 0 10 0 0 10 0 1 20 1 10 0 1 10 20 10 20
1 10 0 20 10 10 10 1 1 1 0 1 0 10 1 1 10 1 1 0 10 0 0 20 1 0 20 20 1 10 20 20 10 10 0 20 10 20 20 1 0 0 20 0 1 20 0 10 20 0
1 10 1 0 0 1 20 20 0 0 1 10 10 20 10 1 20 1 20 0 1 0 1 0 20 1 20 1 10 20 0 10 1 1 1 0 1 10 1 10 10 1 0 0 0 20 1 20 1 20
20 1 10 0 20 1 1 20 0 1 10 1 20 10 0 1 0 0 10 1 0 20 1 1 1 0 1 0 20 0 0 20 0 10 1 0 10 20 0 20 20 20 1 20 1 1 20 20 0 20
0 10 1 0 10 0 0 10 0 10 0 20 1 1 1 10 0 1 10 10 1 20 0 20 10 1 20 20 10 10 0 20 10 10 10 10 1 10 1 10 10 20 0 10 20 20 1 10 20 1
20 1 20 10 20 0 10 0 20 0 0 10 20 10 1 0 1 0 1 0 0 20 10 1 20 20 20 20 10 20 0 20 1 1 20 1 0 0 1 20 20 0 10 20 20 1 0 0 0 0
20 1 1 10 1 20 1 20 0 0 20 20 0 0 0 10 1 20 20 1 10 10 10 10 20 10 20 0 0 20 1 0 10 10 0 20 10 1 10 10 0 20 0 10 1 10 0 0 0 0
0 0 10 10 20 20 0 20 20 20 1 0 20 10 20 1 1 10 10 0 10 0 20 20 1 10 20 20 10 10 1 0 0 0 0 10 0 20 0 0 20 1 10 20 10 0 10 1 1 20
0 20 10 0 20 0 10 1 10 20 0 10 20 0 1 20 0 10 0 10 0 20 20 20 0 0 10 10 10 20 10 1 1 20 0 20 1 10 20 0 1 0 0 10 20 20 0 20 0 10
20 0 20 20 20 1 10 0 20 10 20 1 1 10 1 10 10 1 20 10 0 20 0 0 0 20 0 1 10 10 10 20 1 1 10 0 20 20 1 10 1 20 20 10 20 0 20 10 10 10
1 20 10 10 0 20 10 1 20 20 1 10 10 0 10 0 1 20 0 1 0 20 0 0 20 10 10 0 0 10 10 10 20 1 20 1 1 20 0 0 0 0 20 20 1 10 10 10 20 20
0 20 0 10 0 10 10 10 0 1 20 20 1 1 0 1 0 20 10 10 0 20 10 0 10 20 20 0 1 20 1 1 0 0 0 20 1 1 1 1 0 1 1 0 10 10 0 10 10 10
0 0 1 20 1 0 0 0 20 10 0 20 10 20 1 1 1 10 20 0 20 20 1 10 1 1 20 10 0 1 20 0 10 20 10 1 20 20 0 0 10 0 1 1 20 20 1 10 20 0
20 1 10 0 1 10 0 20 20 1 0 0 1 1 1 1 1 10 1 1 10 1 20 20 1 20 20 1 10 20 1 0 20 10 10 1 20 20 10 1 10 20 20 1 10 20 0 1 1 1
10 10 10 0 20 10 1 20 20 20 20 20 0 10 1 0 0 1 20 1 10 20 0 20 10 20 0 1 0 0 10 1 0 20 0 0 1 1 20 10 20 20 20 0 20 20 20 20 0 1
1 10 1 1 1 20 0 20 10 10 1 1 0 1 20 20 0 20 10 1 1 20 10 0 0 0 20 10 20 20 1 0 1 0 10 0 1 1 10 0 20 20 10 0 20 10 0 20 10 20
10 1 10 0 1 20 1 0 20 20 20 0 0 10 20 1 10 20 0 10 20 10 1 0 0 1 20 0 20 10 10 1 0 1 1 0 20 20 10 0 0 20 1 1 0 20 20 20 0 20
10 10 0 10 20 1 10 1 1 20 20 0 0 1 0 1 0 10 1 0 20 0 10 1 0 20 10 0 1 20 1 10 0 0 1 20 1 1 1 20 20 20 0 1 0 20 20 10 10 20
10 10 0 20 0 1 0 10 10 0 10 0 1 10 0 10 1 1 20 10 0 20 10 20 0 10 10 20 1 0 20 20 20 10 1 10 10 20 0 10 20 0 0 0 20 20 20 10 1 0
1 10 0 10 20 0 0 10 20 0 10 1 20 1 20 20 10 1 10 0 10 20 1 10 0 1 20 20 10 1 0 1 20 10 1 20 0 10 20 1 1 20 0 20 10 20 20 10 20 0
1 20 1 0 10 0 20 0 10 0 20 20 20 20 10 10 10 10 20 1 20 0 10 0 10 1 0 20 20 10 0 20 10 1 10 10 20 10 20 1 0 10 0 0 1 10 0 1 20 0
10 1 0 10 0 20 10 0 1 10 10 20 10 10 20 1 20 1 20 10 10 0 0 20 0 20 20 20 10 1 1 0 20 1 20 20 1 0 0 10 1 0 1 1 20 0 0 20 1 1
20 10 10 0 20 1 10 10 0 1 1 0 0 10 1 20 0 0 0 10 10 1 0 1 20 1 1 10 10 20 0 10 10 1 1 20 1 0 0 20 1 1 20 20 20 20 0 1 10 0
0 20 1 1 20 1 1 10 10 0 1 10 0 0 10 0 10 20 1 10 1 20 10 1 10 10 20 10 0 0 10 20 20 1 0 1 0 20 10 0 0 10 0 20 10 10 20 10 1 1
20 1 1 10 10 20 0 1 0 20 0 20 20 10 0 0 0 1 0 0 20 0 1 20 0 10 0 1 20 20 10 1 0 0 0 20 10 10 20 20 1 10 10 0 10 20 20 10 0 1
0 0 0 1 20 1 0 0 0 1 20 0 1 10 0 0 10 0 1 20 10 1 10 0 1 1 20 1 0 10 10 10 10 20 0 20 1 10 1 0 0 10 1 20 10 10 10 20 20 20
0 1 1 0 0 0 10 20 1 1 20 20 10 10 0 0 20 10 20 20 10 10 10 20 1 20 1 20 20 0 20 1 20 0 20 10 20 20 20 10 0 1 0 10 1 0 1 1 20 20
0 0 0 20 1 10 20 1 10 10 10 0 10 10 1 1 10 20 10 20 1 10 1 0 20 20 20 1 1 0 1 1 10 1 20 10 1 1 1 20 1 20 0 1 1 1 10 10 1 1
10 20 0 20 0 10 1 10 20 20 20 10 0 1 0 1 10 20 1 1 10 0 10 1 1 10 10 0 20 10 0 10 20 0 1 0 0 0 0 10 10 1 1 20 10 10 10 1 1 10
20 10 0 0 10 10 0 20 10 1 0 10 20 20 0 0 10 10 10 1 1 1 20 0 10 20 20 0 1 1 10 0 10 20 0 0 20 0 1 1 10 1 0 0 20 0 1 10 1 1
1 10 1 1 20 20 10 1 0 20 20 1 10 0 10 10 1 20 20 0 10 20 0 0 0 20 10 1 20 10 0 1 10 1 10 20 10 10 1 20 1 0 1 1 0 20 20 1 20 1
0 10 0 1 10 10 20 20 1 10 10 1 1 10 1 0 10 20 20 1 20 20 1 10 20 1 10 0 1 1 0 20 0 10 10 0 20 10 10 1 1 10 1 1 10 20 1 20 20 1
10 1 1 10 1 1 10 0 0 20 1 10 10 0 1 0 1 20 10 10 1 0 0 20 1 1 1 10 20 0 20 0 0 1 1 20 0 10 0 20 20 0 1 0 1 0 1 20 0 10
1 0 20 0 20 20 1 10 1 1 10 1 1 1 1 10 0 0 20 0 20 10 20 0 10 10 10 0 20 0 1 1 20 1 0 10 20 10 10 10 10 1 20 1 1 0 0 10 20 20
1 20 1 1 20 10 1 10 1 20 20 20 0 1 0 1 10 1 20 10 20 0 0 1 1 1 10 1 10 20 0 1 20 0 0 20 0 10 0 10 1 1 1 0 20 1 0 20 10 1
10 10 1 1 20 20 1 0 10 0 20 1 0 10 1 10 20 10 1 1 1 20 10 10 1 10 20 10 20 1 20 20 10 1 0 0 20 1 10 10 0 0 1 10 0 10 10 1 1 0
20 10 10 0 10 20 20 20 10 20 1 1 10 10 10 0 20 1 0 1 1 20 0 20 20 0 20 1 10 10 0 10 1 1 1 20 10 20 20 1 0 0 10 0 10 10 10 20 20 0
10 1 10 0 20 20 20 20 0 10 10 0 20 0 0 20 1 10 1 20 1 1 1 1 10 10 1 0 10 10 20 10 1 1 0 0 20 1 10 1 1 20 10 20 10 10 0 20 1 10
1 10 1 20 20 20 10 10 20 10 10 0 0 10 10 20 0 0 1 1 20 0 1 10 10 20 1 20 0 1 20 20 10 0 20 20 1 1 0 10 10 20 10 20 1 0 20 1 1 10
1 10 20 20 0 20 0 1 0 0 0 10 10 1 1 1 0 0 1 20 1 0 20 0 10 1 20 1 1 1 0 0 0 10 1 20 10 0 20 0 20 1 10 0 10 0 10 10 10 20
0 10 10 1 0 20 10 20 1 0 1 1 0 10 0 20 10 20 20 0 1 1 10 10 20 10 20 20 0 10 20 1 1 1 1 1 1 20 10 1 1 1 1 1 10 10 20 10 1 20
20 10 20 10 10 20 10 1 1 0 0 1 1 0 1 0 0 0 10 0 10 10 0 1 20 20 10 10 20 20 20 20 10 20 0 10 1 0 1 20 0 1 1 0 10 0 20 0 10 1
10 20 20 0 0 20 10 10 20 10 10 1 0 0 0 20 0 10 0 0 0 20 0 20 0 10 0 20 0 0 10 10 1 20 20 1 1 20 1 1 1 0 10 10 20 1 1 10 1 0
0 0 0 1 10 1 0 20 1 20 20 0 10 1 0 0 0 10 10 10 10 1 1 10 1 0 1 10 10 20 1 20 20 0 1 10 0 1 10 20 0 1 1 1 1 20 20 20 0 20
0 20 0 10 20 20 10 0 1 0 1 0 0 20 20 0 10 1 20 1 10 20 1 1 10 10 20 20 1 20 1 0 20 10 20 0 10 0 1 10 0 10 20 20 20 1 20 20 0 10
0 10 20 20 0 20 1 20 0 20 20 0 1 0 10 20 20 10 20 0 10 10 1 1 1 1 1 20 10 20 10 10 1 0 1 1 1 20 10 0 0 1 0 20 10 0 1 20 0 1
10 20 1 20 1 20 10 10 20 0 10 10 1 0 0 20 10 20 0 0 20 10 20 20 1 20 20 1 1 1 10 10 10 10 10 20 0 10 1 1 1 1 10 1 0 0 0 20 20 0
1 20 1 0 1 20 1 0 0 1 10 10 1 20 20 20 1 0 1 1 0 0 10 0 10 0 0 20 0 20 20 0 0 0 20 20 10 1 1 20 1 0 20 1 10 0 20 0 10 20
player 1 1
balloon 5 5