20 15
22222222222222222222
20000000000000000002
20000000000000000002
20000000000000000002
20000000000000000002
20000000000020000002
20000000000020000002
20000000000020000002
20000000000020000002
20000000000000000002
20000000000000000002
20000000000000000002
20000000000000000002
20000000000000000002
22222222222222222222
player 6 6