50 50
22222222222222222222222222222222222222222222222222
20011220020102022001000000010100101200202101000202
20120003001102210502000102000021201000220012100102
20000010010002121200200021000011210200010000221202
20004001000010001111222202210000220010002000201012
20001021200112200102201201010000010002021000200002
22100111002020020000011200021000100021010000200222
21002010010101111120002202200000002100000000222002
22202020020000000100010010200012001010121102012002
20200121010020200002000122010211020100000001012002
20000012210000020001001020020201112010100221020002
20212000122100100000200200011000201001102002100022
20100000100210002210212000012020221002001000000112
20000101121202021211012200000000000000000200102212
22200020000000102022000002101001100001100012221012
20201111002010000100000200000200221022000122110002
20010000012121000200000111020022200200000011210022
20222100200000110000012010020022010011102001000202
21220001000211011000010000220000012010000020022212
20100101020012020020020021000011000200220010001122
22000002121011000100102002022000100000200012012102
20002010201020000000222010111020200110100002001022
20020200202210100012001002201000100000011100122002
20100001120000000221000201002100010210022010001222
20001011000021021100100201102000102020020020000222
20020102012201210102000000001022000100001010021022
22022111001002111000001001000122200000000220000022
20110210200002022020001002100220100011000020000112
22000022202010000001000000121100220120012110100002
20102001100011000012212000000000102222002100000212
20020120102000202010000212101011000010012220000002
21001202100102000001000220201121010020002100200002
20120001121120220010000000000120020200001010221002
20001002200100012001021001200210200200020100101202
22000000112100001020200000120102001001222001002102
21010000021000000200000112201011020000102102002222
21002100210020001011020202002000000102010000211022
20010200001011000220021002200001100200000100211222
20201020001001201210022000000011000002101201022002
20201000220110200000200000100201122100211120000002
20002002002001200001012010010002202001102001001122
20010210001012000020201012100122020000000100210022
22002000001010201000002000001012212001201012002102
20100000001101020100202002001202001120020100020122
20000101000211010021120020200012000002010022002012
20001020000011001202020010220010002002021001012102
20021102000000121000022100102011200000200012020012
22100210001012000201011002002220000000010121200002
20110002010120020002000101202020000222100011010002
22222222222222222222222222222222222222222222222222
player 1 1