50 50
02001001220020200221200002121202022100221120210220
10211011212021011212111202220202111100001000212101
20000122022120221010010211121212002001201102001122
10200122200110212201100001212222211211110210100220
22011020112212010010210200012002222210210112001220
12111000000020122111222021110222112200002211001212
20211210200220112221202012220212220102211021022011
02002102102112201120220111101002120202201012201102
22000121220021111012000021220001202201222122200021
00100210001100100101022200112000212121210021210010
02221121010211120111202111211100222212220202211211
11202112211101011000011111210212002111210001210111
12110100110202120200202002221021001012211122101011
11222012202211012022010200211221022110221212010000
01221001010111012101122212010011111112122020120021
22001200221102220020222000000011012002002201212020
21101220102001002211122020111211221210002201120022
21120000111120110011002111111201111210222122001220
12211011122021100101121112020211210212212122000011
12120011202201111100020121022122010202110002022012
02200101101010202012110210200222010000020011220201
22121202112222020022110222120212101121212221210121
21000122200210222212201000112101212202000121110110
12121121022102011121122212210122222110121000122021
11020211101010011202200000000012221201122112100000
20001200011022010020121120112121012201202021222112
20112112221122120221100022201002222021201202221112
10121121000111202000221012001210000212111002201121
21110020201022201021221210022122112222100102122012
20000000012222201210211120111111111001111222011022
12020002102100000022011121100212122002210110202211
20100020221000201201111202020101012021122010100011
20101000211201001101200020201021020201022121010211
22100220111010211020200010211110222112012111221101
20101221110102110112200221001022120212021200010001
20012112112020110010222101020010002100210212010121
12001110122201201121020101100210110210111202211120
11100021100221001002102101021210222101001112021121
21222002000002002122022021101210001101202112210222
20012100212010111010011111100101112221012010021001
20000221112101200211210110021122101201200020121212
02100120110001111100222121220201102222112112220211
20212211022100101210011001021111110122222120012012
00010001112202202120001010221021000012121001222221
22220010202202002220121022012022012101212012011021
02002022022221022121120122102100021211022201020120
11020222022022111222201111021001010110022122221210
01221002200001211211221222212222200020122122202011
02211001102221002001020000202110011201110211120110
12211022101220220101022002111111120012102120212121
player 1 1
balloon 5 5